af - Africaans
ar - Arabic
bg - Bulgarian
bn - Bengali
ca - Catalan
ckb- Curdish
cz - Czech
da - Danish
de - German
el - Greek
en - English
eo - Esperanto
es - Spain
et - Estonian
eu - Basque
fa - Persian
fi - Finnish
fr - French
ga - Irish
gl - Galician
hi - Hindi
he - Hebrew
hr - Croatian
hu - Hungarian
hy - Armenian
id - Indonesian
it - Italian
ja - Japanese
ko - Korean
la - Latin
lt - Lithuanian
lv - Latvian
mr - Marathi
nl - Dutch
no - Norwegian
pl - Polish
pt - Portuguese
ro - Romanian
ru - Russian
sk - Slovak
sl - Slovenian
so - Somali
st - Sotho
sv - Swedish
sw - Swahili
th - Thai
tr - Turkish
yo - Yoruba
zh - Chinese
zu - Zulu


